[SYMBOL]
V<^>
[TILES]
11111111111
10000000001
10000000001
10000000001
10000000001
10000000001
10000000001
10000000001
10000000001
10001210001
11111011111
[MOBS]
2 5 5
