[SYMBOL]
++++
[TILES]
00001210000
00001010000
00001010000
00001010000
11111011111
20000000002
11111011111
00001010000
00001010000
00001010000
00001210000
[MOBS]
1 5 5
