[TILES]
11000000011
10000000001
00000000000
00000000000
00000000000
00000000000
00000000000
00000000000
00000000000
10000000001
11000000011
