[SYMBOL]
****
[TILES]
11111011111
10000000001
10000000001
10000000001
10000000001
00000600000
10000000001
10000000001
10000000001
10000000001
11111011111
