[SYMBOL]
|-|-
[TILES]
11111211111
10000000001
10000000001
10000000001
13333233331
20000000002
10000000001
10000000001
10000000001
10000000001
11111211111
[MOBS]
1 2 2
1 4 3
1 6 4
1 8 3
1 9 2
