[TILES]
11111211111
10001010001
10111011101
10100000101
10100000101
10100000101
10100000101
10100000101
10111211101
10000000001
11111211111
[MOBS]
1 5 3
1 6 4
1 5 5
